#########################
#.............###xxxxx###
#.............###x----###
#.............###x----###
#.............###x----###
#.............###x----###
#.............###x----###
#.............###x----###
#.............###x----###
#.............###x----###
#.............###x----###
#.............###x----###
#.............###x----###
#.............###x----###
#.............###xxxxx###
#.............###########
#.............###########
#################00000###
#########################
