#########################
#.............###xxxxx###
#.............###x----###
#.............###x----###
#.............###x----###
#.............###x----###
#.............###x----###
#.............###x----###
#.............###x----###
#.............###x----###
#.............###x----###
#.............###x----###
#.............###x----###
#.............###x----###
#.............###xxxxx###
#.............###########
#.............##0000000##
#########################
#########################
