#########################
#.............###########
#.............###.....###
#.............###.....###
#.............###.....###
#.............###.....###
#.............###.....###
#.............###.....###
#.............###.....###
#.............###.....###
#.............###.....###
#.............###.....###
#.............###########
#.............###########
#.............###########
#z............##.......##
#zzz..........###########
#########################
#########################
