#########################
#.............###########
#.............###-----###
#.............###-----###
#.............###-----###
#.............###-----###
#......3......###-----###
#......3......###-----###
#......3......###-----###
#......3......###-----###
#.............###-----###
#.............###-----###
#.............###########
#.............###########
#.............###########
#1..22........##0000000##
#11122........###########
#########################
#########################
