#########################
#.............###########
#.............###-----###
#.............###-----###
#.............###-----###
#.............###-----###
#.............###-----###
#.............###-----###
#.............###-----###
#.............###-----###
#.............###-----###
#.............###-----###
#.............###########
#.............###########
#.............###########
#.............##0000000##
#.............###########
#########################
#########################
