#########################
#.............###xxxxx###
#.............###x----###
#.............###x----###
#.............###x----###
#.............###x----###
#.............###x----###
#.............###x----###
#.............###x----###
#.............###x----###
#.............###x----###
#.............###x----###
#.............###x----###
#.............###x----###
#.............###########
#.............###+++++###
#.............###########
#################00000###
#########################
#########################
#########################